XXOXOOXXXX
OOOXOOOOOO
OOOXOXXXOX
OOOOOOOOOX
XOOOOOOXOO
XOOOOOOXOX
OOOOOOOXOX
XXOOOOOXOX
OOOOOOOOOO
OOOOXXXXXX




