XXXOOOOOOX
OOOOOOOOOX
OXXXXXXOOO
OOOOOOOOOO
OOOOOOOOOO
XXXXOOXXXX
OOOOOOOOOO
OOXXXOXXXO
OOOOOOOOOX
XXOXXOXXOX
