XXXXOXXOOX
OOOOOOOOOX
XXXOOXOOOX
OOOOOXOOOX
XXXOOOOOOX
OOOOOXXOOX
OXXXOOOOOO
OOOOOOOOOO
XXXOOOOOOO
OOOOOXXXOO
